5 5
. # # # .
. # . # #
. # . . #
. # . . #
. # # # #